11	Il
a	à
à	a
celle	cette
celte	cette
cotte	cette
do	de
doux	deux
eu	en
fît	fit
II	Il
la	le
ll	Il
môme	même
mou	mon
nia	ma
niais	mais
nie	me
noire	notre
on	en
on	ou
ôtait	était
ou	eu
ou	on
où	on
peur	pour
pou	peu
Riais	Mais
rosé	rose
sa	se
sou	son
tète	tête
voua	vous
