10th	loth
2	?
45	%
55	"
60th	both
ab	ah
act	art
add	arid
adventure	advent me
aerial	serial
aestival	festival
aged	aped
aide	side
al	ai
ali	all
all	ail
all	fill
Allen	alien
an	ah
and	2nd
and	add
and	anal
and	ants
and	arid
anger	auger
appear	appeal
ARE	ABE
are	arc
are	art
are	ate
are	sire
are a	area
Arms	Anus
aroused	groused
array	away
as	air
as	is
as	us
auger	anger
away	ray
b	h
back	hack
back	tack
Ball	Tail
bang	hang
bank	back
bard	hard
bare	hare
barn	ham
barry	harm
barry	harry
bas	has
baste	haste
bat	hat
battle	baffle
Battle	Rattle
baud	bend
bay	hay
bc	be
bc	he
be	toe
bean	beau
bearing	hearing
bears	hears
beat	heat
beating	heating
beau	bean
because	became
beef	beet
been	bean
been	beets
been	boon
Beep	Keep
beer	hear
beet	best
began	begun
being	bang
being	bring
beings	brings
believe	relieve
bench	beach
bend	baud
best	hest
bid	hid
bide	hide
Bight	Right
bills	hills
bind	hind
bis	his
bits	hits
bitter	hitter
board	hoard
bold	hold
bold	land
boll	bell
bone	hone
book	hook
Books	Boobs
books	hooka
books	hooks
born	horn
born	how
bot	but
bot	hot
both	60th
bound	hound
bouse	house
bow	born
bowl	howl
boy	hoy
boy	toy
bp	hp
bull	hull
bunch	hunch
bunt	hunt
burn	bum
burned	hurried
bush	hush
but	bat
but	hut
But	Out
by	hy
by	toy
bye	lye
c	e
cafe	case
came	carne
came	carrie
came	Mine
card	curd
carriage	carnage
carrie	came
carried	earned
carries	curries
case	east
cased	eased
cases	eases
cast	oust
cd	ed
celt	colt
CHAPTER	CHARTER
CHAPTER	CHATTER
checks	cheeks
cheeks	checks
chief	thief
chill	dull
chillest	dullest
chilly	dully
close	dose
cloth	doth
clutch	dutch
cm	cry
cock	code
code	cock
coin	cow
coins	cows
comer	coiner
comes	conies
cookies	cockles
corn	coin
corn	cow
corner	comer
course	coarse
cover	covet
covering	coveting
cow	coin
cow	corn
cows	coins
cry	cm
cucumbers	encumbers
custom	eastern
customer	easterner
cut	cat
Dale	Pale
damn	dawn
dancers	lancers
dawn	damn
day	clay
day	tiny
days	clays
dc	de
de	dc
defect	detect
defected	detected
defective	detective
defects	detects
detect	defect
detected	defected
detects	defects
die	did
Dime	Dine
Dime	Due
Dime	One
does	docs
dog	clog
done	dope
DOOR	BOOK
down	clown
down	dawn
drain	dram
drain	draw
draw	drain
Dreams	Breams
drum	dram
dull	chill
dully	chilly
e	c
ear	car
earned	carried
eased	cased
east	cast
eastern	custom
eat	cat
economics	economies
ed	cd
Eight	Night
enable	unable
END	BIND
even	oven
expense	expanse
express	caress
eye	eve
fact	fast
facts	fads
failing	falling
fails	falls
fall	fail
falling	failing
falls	fails
fame	fate
famous	fatuous
far	fax
farmer	fanner
Fasting	Pasting
fatal	fetal
fate	fame
feel	feet
fiat	flat
Fiddles	Piddles
Fields	Molds
FIG	BIG
fig	fin
fight	tight
File	Pile
files	flies
Fill	Pill
fine	Cue
fine	flue
finger	ringer
fingers	ringers
fist	list
fit	lit
five	fire
five	live
flattish	flatfish
flies	files
floor	flour
flour	floor
flour	Hour
flourish	nourish
flourished	nourished
flows	flown
flushing	Hushing
foe	toe
foil	full
for	far
for	fur
for	tor
form	porn
Four	Pour
fowls	jowls
France	Prance
from	front
full	fall
furnish	famish
further	farther
gain	gary
gained	gamed
gaining	gaming
gary	gain
gave	crave
get	got
gift	gilt
go	so
Gracie	Grade
grain	gram
great	grout
Green	Given
gum	guru
h	b
had	lad
half	hall
hall	ball
ham	barn
hand	band
handed	banded
hands	bands
hang	bang
hard	bard
hare	bare
harm	harry
harry	barry
harry	harm
has	bas
has	hag
haste	baste
hat	bat
hath	bath
having	haying
hay	bay
he	life
He	Pie
head	bead
heads	Beads
heads	beads
hear	bear
heard	beard
hearing	bearing
hears	bears
heat	beat
heating	beating
heed	hoed
hell	bell
her	heir
her	lier
her	lies
here	hero
here	tee
hero	here
Herr	Heir
hide	bide
high	nigh
hills	bills
him	hint
him	Trim
him	turn
hire	nice
his	bis
his	hie
his	ills
his	Ms
his	tis
hit	bit
hits	bits
hitter	bitter
hoar	boar
hold	bold
home	borne
home	to me
hone	bone
hooks	books
horn	born
horses	horns
hound	bound
Hound	Round
hour	tour
house	bouse
how	bow
How	I low
howl	bowl
howler	bowler
hoy	boy
hp	bp
hull	bull
humbled	bumbled
hunch	bunch
hundred	bundled
hunt	bunt
hurried	burned
hush	bush
hy	by
I	!
ice	lee
ie	le
iii	ill
Ill	111
ill	iii
in	hi
inc	me
inc	we
inn	run
into	info
into	Into
is	ip
joy	icy
Keep	Beep
knew	know
l	i
ladies	ladles
LAMB	LAME
lame	tame
land	laud
last	fast
late	Into
later at	lateral
lay	Jay
le	ie
lead	fond
leader	leafier
lee	ice
lee	Ice
lets	lots
life	lifts
lift	lilt
lilt	lift
line	fine
list	fist
live	I've
living	Hiring
load	loud
locked	looked
locks	looks
looks	locks
loot	hot
loss	logs
loves	lores
mail	wall
main	mary
main	warn
make	wake
males	wales
man	ban
man	nun
married	warned
marry	warm
mary	main
match	watch
matched	watched
matching	watching
May	flay
may	nay
may	way
may be	maybe
me	rate
me	rue
me	we
mere	were
merit	went
met	wet
mild	wild
Mile	Mlle
mill	will
mind	wind
minds	winds
mine	wine
mines	wines
Miss	Hiss
Mlle	Mile
Mlle.	Mile.
mm	win
moat	meat
mock	mode
Mode	Mock
mode	mock
modern	modem
month	mouth
mood	wood
more	move
more	noire
more	wore
morn	mom
motory	motors
mouth	month
Mr	Sir
Mr.	Mr
Mr.	Mr,
Mrs.	Mrs
Mrs.	Mrs,
much	ranch
mules	nudes
must	mast
muttered	mattered
my	nay
my	ray
natives	Datives
Near	Hear
Nearing	Wearing
New	Hew
NEW	MEW
next	nest
no	110
no	do
No	So
nose	rose
not	act
not	cot
not	rot
not	sot
noted	rioted
noting	hurting
now	mow
o	0
ob	oh
of	o
OF	OP
of face	efface
oh	ob
on	an
one	cue
other	ether
our	bur
our	car
our	cur
out	cut
out	oat
over	oven
oxalate	oxidate
Paris	Pans
passed	parsed
past	part
Pasting	Fasting
person	parson
Pile	File
Pill	Fill
pin	pm
plain	plum
pm	pin
poet	post
poets	posts
Poison	Person
preface	pie-face
PRICE	PRICK
prunes	primes
Publishing	Punishing
qualities	qualifies
Rack	Back
rain	ram
ram	raw
Rate	Bate
rather	ratter
raw	rain
Re	Be
reached	reacted
reacted	reached
read	react
Reader	Header
Rear	Bear
Red	Bed
religions	religious
remained	retrained
Rest	Best
retreating	recreating
returned	retained
Rifle	Kills
Right	Bight
Right	Eight
right	fight
right	tight
rightness	tightness
rise	use
rises	uses
rising	using
roar	rear
Roast	Boast
rocks	rooks
Rome	Borne
Rome	Home
Rose	Hose
rote	note
rubber	rub her
ruin	rum
ruined	mined
RUMP	BUMP
run	inn
run	ran
run	rum
runs	nuns
rustle	rustic
sack	Back
said	paid
said	wild
sail	salt
salts	waits
sam	saw
sand	sund
save	saw
saving	saying
saw	sam
scat	seat
seat	scat
see	are
see	sea
seen	Been
served	saved
shalt	shall
Shame	Slime
she	site
sherry	cherry
shew	skew
ship	skip
shore	shove
short	snort
side	Bide
skie	side
skin	akin
sleep	sloop
small	email
so	go
so	to
some	borne
some	come
some	sonic
son	eon
Spain	Spam
stairs	stabs
steading	stealing
stein	stem
stem	stein
stem	stern
step	stop
stern	stem
stewed	stowed
still	stall
stories	stones
strain	straw
straw	strain
summer	slimmer
sunning	gunning
swift	swill
swore	more
tail	tall
taking	faking
tall	tail
tame	lame
tameness	lameness
ten	fen
term	terry
terry	term
that	thai
the	die
the	lie
the	me
the	tho
the	tie
the	tile
THE	TUB
their	then
them	thorn
then	men
these	those
thing	tiling
this	thin
this	tins
through	thrown
thrush	thrash
tic	tie
tight	fight
tightness	rightness
time	lime
time	tune
times	rimes
timings	tintings
tin	try
tiny	day
to me	tome
tom	torn
tom	tory
too	ton
top	ton
torn	tom
Torn	Tom
torn	tory
tory	tom
train	tram
traits	trails
tried	tied
try	fry
try	tin
TUB	THE
turn	tum
under	wider
ungifted	unsifted
un-polished	tin-polished
up	lip
up	rip
up	tip
use	rise
uses	rises
using	rising
vessels	weasels
von	you
w	in
w	m
waits	salts
wake	make
wales	males
walked	wafted
wall	mail
walls	wails
Walt	Halt
Walter	Waiter
war	wax
warm	marry
warn	main
warn	mary
warned	married
was	vas
was	wag
was	wan
watch	match
watched	matched
watching	matching
way	may
we	inc
we	me
well	wall
well	wen
went	merit
were	mere
were	wore
West	Best
wet	met
where	whore
which	winch
who	ho
wild	mild
will	mill
will	trill
wills	trills
win	mm
winds	minds
wine	mine
wines	mines
woman	Women
WOMEN	WOMBS
wood	mood
wounded	mounded
y	v
Yale	Yak
YEAR	TEAR
year	your
Years	Tears
yet	jet
yet	vet
you	von
you	yon
Your	Tour
